pokemon_id,identifier,hp,attack,defense,special_attack,special_defense,speed,basestattotal,combined_types
1,bulbasaur,45,49,49,65,65,45,318,"grass, poison"
2,ivysaur,60,62,63,80,80,60,405,"grass, poison"
3,venusaur,80,82,83,100,100,80,525,"grass, poison"
4,charmander,39,52,43,60,50,65,309,fire
5,charmeleon,58,64,58,80,65,80,405,fire
6,charizard,78,84,78,109,85,100,534,"flying, fire"
7,squirtle,44,48,65,50,64,43,314,water
8,wartortle,59,63,80,65,80,58,405,water
9,blastoise,79,83,100,85,105,78,530,water
10,caterpie,45,30,35,20,20,45,195,bug
11,metapod,50,20,55,25,25,30,205,bug
12,butterfree,60,45,50,90,80,70,395,"flying, bug"
13,weedle,40,35,30,20,20,50,195,"bug, poison"
14,kakuna,45,25,50,25,25,35,205,"bug, poison"
15,beedrill,65,90,40,45,80,75,395,"bug, poison"
16,pidgey,40,45,40,35,35,56,251,"normal, flying"
17,pidgeotto,63,60,55,50,50,71,349,"normal, flying"
18,pidgeot,83,80,75,70,70,101,479,"normal, flying"
19,rattata,30,56,35,25,35,72,253,normal
20,raticate,55,81,60,50,70,97,413,normal
21,spearow,40,60,30,31,31,70,262,"normal, flying"
22,fearow,65,90,65,61,61,100,442,"normal, flying"
23,ekans,35,60,44,40,54,55,288,poison
24,arbok,60,95,69,65,79,80,448,poison
25,pikachu,35,55,40,50,50,90,320,electric
26,raichu,60,90,55,90,80,110,485,electric
27,sandshrew,50,75,85,20,30,40,300,ground
28,sandslash,75,100,110,45,55,65,450,ground
29,nidoran-f,55,47,52,40,40,41,275,poison
30,nidorina,70,62,67,55,55,56,365,poison
31,nidoqueen,90,92,87,75,85,76,505,"ground, poison"
32,nidoran-m,46,57,40,40,40,50,273,poison
33,nidorino,61,72,57,55,55,65,365,poison
34,nidoking,81,102,77,85,75,85,505,"ground, poison"
35,clefairy,70,45,48,60,65,35,323,fairy
36,clefable,95,70,73,95,90,60,483,fairy
37,vulpix,38,41,40,50,65,65,299,fire
38,ninetales,73,76,75,81,100,100,505,fire
39,jigglypuff,115,45,20,45,25,20,270,"normal, fairy"
40,wigglytuff,140,70,45,85,50,45,435,"normal, fairy"
41,zubat,40,45,35,30,40,55,245,"flying, poison"
42,golbat,75,80,70,65,75,90,455,"flying, poison"
43,oddish,45,50,55,75,65,30,320,"grass, poison"
44,gloom,60,65,70,85,75,40,395,"grass, poison"
45,vileplume,75,80,85,110,90,50,490,"grass, poison"
46,paras,35,70,55,45,55,25,285,"grass, bug"
47,parasect,60,95,80,60,80,30,405,"grass, bug"
48,venonat,60,55,50,40,55,45,305,"bug, poison"
49,venomoth,70,65,60,90,75,90,450,"bug, poison"
50,diglett,10,55,25,35,45,95,265,ground
51,dugtrio,35,100,50,50,70,120,425,ground
52,meowth,40,45,35,40,40,90,290,normal
53,persian,65,70,60,65,65,115,440,normal
54,psyduck,50,52,48,65,50,55,320,water
55,golduck,80,82,78,95,80,85,500,water
56,mankey,40,80,35,35,45,70,305,fighting
57,primeape,65,105,60,60,70,95,455,fighting
58,growlithe,55,70,45,70,50,60,350,fire
59,arcanine,90,110,80,100,80,95,555,fire
60,poliwag,40,50,40,40,40,90,300,water
61,poliwhirl,65,65,65,50,50,90,385,water
62,poliwrath,90,95,95,70,90,70,510,"fighting, water"
63,abra,25,20,15,105,55,90,310,psychic
64,kadabra,40,35,30,120,70,105,400,psychic
65,alakazam,55,50,45,135,95,120,500,psychic
66,machop,70,80,50,35,35,35,305,fighting
67,machoke,80,100,70,50,60,45,405,fighting
68,machamp,90,130,80,65,85,55,505,fighting
69,bellsprout,50,75,35,70,30,40,300,"grass, poison"
70,weepinbell,65,90,50,85,45,55,390,"grass, poison"
71,victreebel,80,105,65,100,70,70,490,"grass, poison"
72,tentacool,40,40,35,50,100,70,335,"poison, water"
73,tentacruel,80,70,65,80,120,100,515,"poison, water"
74,geodude,40,80,100,30,30,20,300,"ground, rock"
75,graveler,55,95,115,45,45,35,390,"ground, rock"
76,golem,80,120,130,55,65,45,495,"ground, rock"
77,ponyta,50,85,55,65,65,90,410,fire
78,rapidash,65,100,70,80,80,105,500,fire
79,slowpoke,90,65,65,40,40,15,315,"psychic, water"
80,slowbro,95,75,110,100,80,30,490,"psychic, water"
81,magnemite,25,35,70,95,55,45,325,"steel, electric"
82,magneton,50,60,95,120,70,70,465,"steel, electric"
83,farfetchd,52,90,55,58,62,60,377,"normal, flying"
84,doduo,35,85,45,35,35,75,310,"normal, flying"
85,dodrio,60,110,70,60,60,110,470,"normal, flying"
86,seel,65,45,55,45,70,45,325,water
87,dewgong,90,70,80,70,95,70,475,"ice, water"
88,grimer,80,80,50,40,50,25,325,poison
89,muk,105,105,75,65,100,50,500,poison
90,shellder,30,65,100,45,25,40,305,water
91,cloyster,50,95,180,85,45,70,525,"ice, water"
92,gastly,30,35,30,100,35,80,310,"ghost, poison"
93,haunter,45,50,45,115,55,95,405,"ghost, poison"
94,gengar,60,65,60,130,75,110,500,"ghost, poison"
95,onix,35,45,160,30,45,70,385,"ground, rock"
96,drowzee,60,48,45,43,90,42,328,psychic
97,hypno,85,73,70,73,115,67,483,psychic
98,krabby,30,105,90,25,25,50,325,water
99,kingler,55,130,115,50,50,75,475,water
100,voltorb,40,30,50,55,55,100,330,electric
101,electrode,60,50,70,80,80,150,490,electric
102,exeggcute,60,40,80,60,45,40,325,"psychic, grass"
103,exeggutor,95,95,85,125,75,55,530,"psychic, grass"
104,cubone,50,50,95,40,50,35,320,ground
105,marowak,60,80,110,50,80,45,425,ground
106,hitmonlee,50,120,53,35,110,87,455,fighting
107,hitmonchan,50,105,79,35,110,76,455,fighting
108,lickitung,90,55,75,60,75,30,385,normal
109,koffing,40,65,95,60,45,35,340,poison
110,weezing,65,90,120,85,70,60,490,poison
111,rhyhorn,80,85,95,30,30,25,345,"ground, rock"
112,rhydon,105,130,120,45,45,40,485,"ground, rock"
113,chansey,250,5,5,35,105,50,450,normal
114,tangela,65,55,115,100,40,60,435,grass
115,kangaskhan,105,95,80,40,80,90,490,normal
116,horsea,30,40,70,70,25,60,295,water
117,seadra,55,65,95,95,45,85,440,water
118,goldeen,45,67,60,35,50,63,320,water
119,seaking,80,92,65,65,80,68,450,water
120,staryu,30,45,55,70,55,85,340,water
121,starmie,60,75,85,100,85,115,520,"psychic, water"
122,mr-mime,40,45,65,100,120,90,460,"psychic, fairy"
123,scyther,70,110,80,55,80,105,500,"flying, bug"
124,jynx,65,50,35,115,95,95,455,"psychic, ice"
125,electabuzz,65,83,57,95,85,105,490,electric
126,magmar,65,95,57,100,85,93,495,fire
127,pinsir,65,125,100,55,70,85,500,bug
128,tauros,75,100,95,40,70,110,490,normal
129,magikarp,20,10,55,15,20,80,200,water
130,gyarados,95,125,79,60,100,81,540,"flying, water"
131,lapras,130,85,80,85,95,60,535,"ice, water"
132,ditto,48,48,48,48,48,48,288,normal
133,eevee,55,55,50,45,65,55,325,normal
134,vaporeon,130,65,60,110,95,65,525,water
135,jolteon,65,65,60,110,95,130,525,electric
136,flareon,65,130,60,95,110,65,525,fire
137,porygon,65,60,70,85,75,40,395,normal
138,omanyte,35,40,100,90,55,35,355,"rock, water"
139,omastar,70,60,125,115,70,55,495,"water, rock"
140,kabuto,30,80,90,55,45,55,355,"water, rock"
141,kabutops,60,115,105,65,70,80,495,"water, rock"
142,aerodactyl,80,105,65,60,75,130,515,"flying, rock"
143,snorlax,160,110,65,65,110,30,540,normal
144,articuno,90,85,100,95,125,85,580,"flying, ice"
145,zapdos,90,90,85,125,90,100,580,"flying, electric"
146,moltres,90,100,90,125,85,90,580,"flying, fire"
147,dratini,41,64,45,50,50,50,300,dragon
148,dragonair,61,84,65,70,70,70,420,dragon
149,dragonite,91,134,95,100,100,80,600,"flying, dragon"
150,mewtwo,106,110,90,154,90,130,680,psychic
151,mew,100,100,100,100,100,100,600,psychic
152,chikorita,45,49,65,49,65,45,318,grass
153,bayleef,60,62,80,63,80,60,405,grass
154,meganium,80,82,100,83,100,80,525,grass
155,cyndaquil,39,52,43,60,50,65,309,fire
156,quilava,58,64,58,80,65,80,405,fire
157,typhlosion,78,84,78,109,85,100,534,fire
158,totodile,50,65,64,44,48,43,314,water
159,croconaw,65,80,80,59,63,58,405,water
160,feraligatr,85,105,100,79,83,78,530,water
161,sentret,35,46,34,35,45,20,215,normal
162,furret,85,76,64,45,55,90,415,normal
163,hoothoot,60,30,30,36,56,50,262,"normal, flying"
164,noctowl,100,50,50,86,96,70,452,"normal, flying"
165,ledyba,40,20,30,40,80,55,265,"flying, bug"
166,ledian,55,35,50,55,110,85,390,"flying, bug"
167,spinarak,40,60,40,40,40,30,250,"bug, poison"
168,ariados,70,90,70,60,70,40,400,"bug, poison"
169,crobat,85,90,80,70,80,130,535,"flying, poison"
170,chinchou,75,38,38,56,56,67,330,"electric, water"
171,lanturn,125,58,58,76,76,67,460,"electric, water"
172,pichu,20,40,15,35,35,60,205,electric
173,cleffa,50,25,28,45,55,15,218,fairy
174,igglybuff,90,30,15,40,20,15,210,"normal, fairy"
175,togepi,35,20,65,40,65,20,245,fairy
176,togetic,55,40,85,80,105,40,405,"flying, fairy"
177,natu,40,50,45,70,45,70,320,"flying, psychic"
178,xatu,65,75,70,95,70,95,470,"flying, psychic"
179,mareep,55,40,40,65,45,35,280,electric
180,flaaffy,70,55,55,80,60,45,365,electric
181,ampharos,90,75,85,115,90,55,510,electric
182,bellossom,75,80,95,90,100,50,490,grass
183,marill,70,20,50,20,50,40,250,"fairy, water"
184,azumarill,100,50,80,60,80,50,420,"fairy, water"
185,sudowoodo,70,100,115,30,65,30,410,rock
186,politoed,90,75,75,90,100,70,500,water
187,hoppip,35,35,40,35,55,50,250,"flying, grass"
188,skiploom,55,45,50,45,65,80,340,"flying, grass"
189,jumpluff,75,55,70,55,95,110,460,"flying, grass"
190,aipom,55,70,55,40,55,85,360,normal
191,sunkern,30,30,30,30,30,30,180,grass
192,sunflora,75,75,55,105,85,30,425,grass
193,yanma,65,65,45,75,45,95,390,"flying, bug"
194,wooper,55,45,45,25,25,15,210,"ground, water"
195,quagsire,95,85,85,65,65,35,430,"ground, water"
196,espeon,65,65,60,130,95,110,525,psychic
197,umbreon,95,65,110,60,130,65,525,dark
198,murkrow,60,85,42,85,42,91,405,"flying, dark"
199,slowking,95,75,80,100,110,30,490,"psychic, water"
200,misdreavus,60,60,60,85,85,85,435,ghost
201,unown,48,72,48,72,48,48,336,psychic
202,wobbuffet,190,33,58,33,58,33,405,psychic
203,girafarig,70,80,65,90,65,85,455,"normal, psychic"
204,pineco,50,65,90,35,35,15,290,bug
205,forretress,75,90,140,60,60,40,465,"steel, bug"
206,dunsparce,100,70,70,65,65,45,415,normal
207,gligar,65,75,105,35,65,85,430,"ground, flying"
208,steelix,75,85,200,55,65,30,510,"ground, steel"
209,snubbull,60,80,50,40,40,30,300,fairy
210,granbull,90,120,75,60,60,45,450,fairy
211,qwilfish,65,95,85,55,55,85,440,"poison, water"
212,scizor,70,130,100,55,80,65,500,"steel, bug"
213,shuckle,20,10,230,10,230,5,505,"bug, rock"
214,heracross,80,125,75,40,95,85,500,"fighting, bug"
215,sneasel,55,95,55,35,75,115,430,"ice, dark"
216,teddiursa,60,80,50,50,50,40,330,normal
217,ursaring,90,130,75,75,75,55,500,normal
218,slugma,40,40,40,70,40,20,250,fire
219,magcargo,60,50,120,90,80,30,430,"fire, rock"
220,swinub,50,50,40,30,30,50,250,"ground, ice"
221,piloswine,100,100,80,60,60,50,450,"ground, ice"
222,corsola,65,55,95,65,95,35,410,"rock, water"
223,remoraid,35,65,35,65,35,65,300,water
224,octillery,75,105,75,105,75,45,480,water
225,delibird,45,55,45,65,45,75,330,"flying, ice"
226,mantine,85,40,70,80,140,70,485,"flying, water"
227,skarmory,65,80,140,40,70,70,465,"flying, steel"
228,houndour,45,60,30,80,50,65,330,"fire, dark"
229,houndoom,75,90,50,110,80,95,500,"fire, dark"
230,kingdra,75,95,95,95,95,85,540,"dragon, water"
231,phanpy,90,60,60,40,40,40,330,ground
232,donphan,90,120,120,60,60,50,500,ground
233,porygon2,85,80,90,105,95,60,515,normal
234,stantler,73,95,62,85,65,85,465,normal
235,smeargle,55,20,35,20,45,75,250,normal
236,tyrogue,35,35,35,35,35,35,210,fighting
237,hitmontop,50,95,95,35,110,70,455,fighting
238,smoochum,45,30,15,85,65,65,305,"psychic, ice"
239,elekid,45,63,37,65,55,95,360,electric
240,magby,45,75,37,70,55,83,365,fire
241,miltank,95,80,105,40,70,100,490,normal
242,blissey,255,10,10,75,135,55,540,normal
243,raikou,90,85,75,115,100,115,580,electric
244,entei,115,115,85,90,75,100,580,fire
245,suicune,100,75,115,90,115,85,580,water
246,larvitar,50,64,50,45,50,41,300,"ground, rock"
247,pupitar,70,84,70,65,70,51,410,"ground, rock"
248,tyranitar,100,134,110,95,100,61,600,"rock, dark"
249,lugia,106,90,130,90,154,110,680,"flying, psychic"
250,ho-oh,106,130,90,110,154,90,680,"flying, fire"
251,celebi,100,100,100,100,100,100,600,"psychic, grass"
252,treecko,40,45,35,65,55,70,310,grass
253,grovyle,50,65,45,85,65,95,405,grass
254,sceptile,70,85,65,105,85,120,530,grass
255,torchic,45,60,40,70,50,45,310,fire
256,combusken,60,85,60,85,60,55,405,"fighting, fire"
257,blaziken,80,120,70,110,70,80,530,"fighting, fire"
258,mudkip,50,70,50,50,50,40,310,water
259,marshtomp,70,85,70,60,70,50,405,"ground, water"
260,swampert,100,110,90,85,90,60,535,"ground, water"
261,poochyena,35,55,35,30,30,35,220,dark
262,mightyena,70,90,70,60,60,70,420,dark
263,zigzagoon,38,30,41,30,41,60,240,normal
264,linoone,78,70,61,50,61,100,420,normal
265,wurmple,45,45,35,20,30,20,195,bug
266,silcoon,50,35,55,25,25,15,205,bug
267,beautifly,60,70,50,100,50,65,395,"flying, bug"
268,cascoon,50,35,55,25,25,15,205,bug
269,dustox,60,50,70,50,90,65,385,"bug, poison"
270,lotad,40,30,30,40,50,30,220,"grass, water"
271,lombre,60,50,50,60,70,50,340,"grass, water"
272,ludicolo,80,70,70,90,100,70,480,"grass, water"
273,seedot,40,40,50,30,30,30,220,grass
274,nuzleaf,70,70,40,60,40,60,340,"grass, dark"
275,shiftry,90,100,60,90,60,80,480,"grass, dark"
276,taillow,40,55,30,30,30,85,270,"normal, flying"
277,swellow,60,85,60,75,50,125,455,"normal, flying"
278,wingull,40,30,30,55,30,85,270,"flying, water"
279,pelipper,60,50,100,95,70,65,440,"flying, water"
280,ralts,28,25,25,45,35,40,198,"psychic, fairy"
281,kirlia,38,35,35,65,55,50,278,"psychic, fairy"
282,gardevoir,68,65,65,125,115,80,518,"psychic, fairy"
283,surskit,40,30,32,50,52,65,269,"bug, water"
284,masquerain,70,60,62,100,82,80,454,"flying, bug"
285,shroomish,60,40,60,40,60,35,295,grass
286,breloom,60,130,80,60,60,70,460,"fighting, grass"
287,slakoth,60,60,60,35,35,30,280,normal
288,vigoroth,80,80,80,55,55,90,440,normal
289,slaking,150,160,100,95,65,100,670,normal
290,nincada,31,45,90,30,30,40,266,"ground, bug"
291,ninjask,61,90,45,50,50,160,456,"flying, bug"
292,shedinja,1,90,45,30,30,40,236,"ghost, bug"
293,whismur,64,51,23,51,23,28,240,normal
294,loudred,84,71,43,71,43,48,360,normal
295,exploud,104,91,63,91,73,68,490,normal
296,makuhita,72,60,30,20,30,25,237,fighting
297,hariyama,144,120,60,40,60,50,474,fighting
298,azurill,50,20,40,20,40,20,190,"normal, fairy"
299,nosepass,30,45,135,45,90,30,375,rock
300,skitty,50,45,45,35,35,50,260,normal
301,delcatty,70,65,65,55,55,90,400,normal
302,sableye,50,75,75,65,65,50,380,"ghost, dark"
303,mawile,50,85,85,55,55,50,380,"steel, fairy"
304,aron,50,70,100,40,40,30,330,"steel, rock"
305,lairon,60,90,140,50,50,40,430,"steel, rock"
306,aggron,70,110,180,60,60,50,530,"steel, rock"
307,meditite,30,40,55,40,55,60,280,"fighting, psychic"
308,medicham,60,60,75,60,75,80,410,"fighting, psychic"
309,electrike,40,45,40,65,40,65,295,electric
310,manectric,70,75,60,105,60,105,475,electric
311,plusle,60,50,40,85,75,95,405,electric
312,minun,60,40,50,75,85,95,405,electric
313,volbeat,65,73,75,47,85,85,430,bug
314,illumise,65,47,75,73,85,85,430,bug
315,roselia,50,60,45,100,80,65,400,"grass, poison"
316,gulpin,70,43,53,43,53,40,302,poison
317,swalot,100,73,83,73,83,55,467,poison
318,carvanha,45,90,20,65,20,65,305,"dark, water"
319,sharpedo,70,120,40,95,40,95,460,"water, dark"
320,wailmer,130,70,35,70,35,60,400,water
321,wailord,170,90,45,90,45,60,500,water
322,numel,60,60,40,65,45,35,305,"ground, fire"
323,camerupt,70,100,70,105,75,40,460,"ground, fire"
324,torkoal,70,85,140,85,70,20,470,fire
325,spoink,60,25,35,70,80,60,330,psychic
326,grumpig,80,45,65,90,110,80,470,psychic
327,spinda,60,60,60,60,60,60,360,normal
328,trapinch,45,100,45,45,45,10,290,ground
329,vibrava,50,70,50,50,50,70,340,"ground, dragon"
330,flygon,80,100,80,80,80,100,520,"ground, dragon"
331,cacnea,50,85,40,85,40,35,335,grass
332,cacturne,70,115,60,115,60,55,475,"grass, dark"
333,swablu,45,40,60,40,75,50,310,"normal, flying"
334,altaria,75,70,90,70,105,80,490,"flying, dragon"
335,zangoose,73,115,60,60,60,90,458,normal
336,seviper,73,100,60,100,60,65,458,poison
337,lunatone,90,55,65,95,85,70,460,"psychic, rock"
338,solrock,90,95,85,55,65,70,460,"psychic, rock"
339,barboach,50,48,43,46,41,60,288,"ground, water"
340,whiscash,110,78,73,76,71,60,468,"ground, water"
341,corphish,43,80,65,50,35,35,308,water
342,crawdaunt,63,120,85,90,55,55,468,"dark, water"
343,baltoy,40,40,55,40,70,55,300,"ground, psychic"
344,claydol,60,70,105,70,120,75,500,"ground, psychic"
345,lileep,66,41,77,61,87,23,355,"grass, rock"
346,cradily,86,81,97,81,107,43,495,"grass, rock"
347,anorith,45,95,50,40,50,75,355,"bug, rock"
348,armaldo,75,125,100,70,80,45,495,"bug, rock"
349,feebas,20,15,20,10,55,80,200,water
350,milotic,95,60,79,100,125,81,540,water
351,castform,70,70,70,70,70,70,420,normal
352,kecleon,60,90,70,60,120,40,440,normal
353,shuppet,44,75,35,63,33,45,295,ghost
354,banette,64,115,65,83,63,65,455,ghost
355,duskull,20,40,90,30,90,25,295,ghost
356,dusclops,40,70,130,60,130,25,455,ghost
357,tropius,99,68,83,72,87,51,460,"flying, grass"
358,chimecho,75,50,80,95,90,65,455,psychic
359,absol,65,130,60,75,60,75,465,dark
360,wynaut,95,23,48,23,48,23,260,psychic
361,snorunt,50,50,50,50,50,50,300,ice
362,glalie,80,80,80,80,80,80,480,ice
363,spheal,70,40,50,55,50,25,290,"ice, water"
364,sealeo,90,60,70,75,70,45,410,"ice, water"
365,walrein,110,80,90,95,90,65,530,"ice, water"
366,clamperl,35,64,85,74,55,32,345,water
367,huntail,55,104,105,94,75,52,485,water
368,gorebyss,55,84,105,114,75,52,485,water
369,relicanth,100,90,130,45,65,55,485,"rock, water"
370,luvdisc,43,30,55,40,65,97,330,water
371,bagon,45,75,60,40,30,50,300,dragon
372,shelgon,65,95,100,60,50,50,420,dragon
373,salamence,95,135,80,110,80,100,600,"flying, dragon"
374,beldum,40,55,80,35,60,30,300,"steel, psychic"
375,metang,60,75,100,55,80,50,420,"steel, psychic"
376,metagross,80,135,130,95,90,70,600,"steel, psychic"
377,regirock,80,100,200,50,100,50,580,rock
378,regice,80,50,100,100,200,50,580,ice
379,registeel,80,75,150,75,150,50,580,steel
380,latias,80,80,90,110,130,110,600,"psychic, dragon"
381,latios,80,90,80,130,110,110,600,"psychic, dragon"
382,kyogre,100,100,90,150,140,90,670,water
383,groudon,100,150,140,100,90,90,670,ground
384,rayquaza,105,150,90,150,90,95,680,"flying, dragon"
385,jirachi,100,100,100,100,100,100,600,"steel, psychic"
386,deoxys-normal,50,150,50,150,50,150,600,psychic
387,turtwig,55,68,64,45,55,31,318,grass
388,grotle,75,89,85,55,65,36,405,grass
389,torterra,95,109,105,75,85,56,525,"ground, grass"
390,chimchar,44,58,44,58,44,61,309,fire
391,monferno,64,78,52,78,52,81,405,"fighting, fire"
392,infernape,76,104,71,104,71,108,534,"fighting, fire"
393,piplup,53,51,53,61,56,40,314,water
394,prinplup,64,66,68,81,76,50,405,water
395,empoleon,84,86,88,111,101,60,530,"steel, water"
396,starly,40,55,30,30,30,60,245,"normal, flying"
397,staravia,55,75,50,40,40,80,340,"normal, flying"
398,staraptor,85,120,70,50,60,100,485,"normal, flying"
399,bidoof,59,45,40,35,40,31,250,normal
400,bibarel,79,85,60,55,60,71,410,"normal, water"
401,kricketot,37,25,41,25,41,25,194,bug
402,kricketune,77,85,51,55,51,65,384,bug
403,shinx,45,65,34,40,34,45,263,electric
404,luxio,60,85,49,60,49,60,363,electric
405,luxray,80,120,79,95,79,70,523,electric
406,budew,40,30,35,50,70,55,280,"grass, poison"
407,roserade,60,70,65,125,105,90,515,"grass, poison"
408,cranidos,67,125,40,30,30,58,350,rock
409,rampardos,97,165,60,65,50,58,495,rock
410,shieldon,30,42,118,42,88,30,350,"steel, rock"
411,bastiodon,60,52,168,47,138,30,495,"steel, rock"
412,burmy,40,29,45,29,45,36,224,bug
413,wormadam-plant,60,59,85,79,105,36,424,"grass, bug"
414,mothim,70,94,50,94,50,66,424,"flying, bug"
415,combee,30,30,42,30,42,70,244,"flying, bug"
416,vespiquen,70,80,102,80,102,40,474,"flying, bug"
417,pachirisu,60,45,70,45,90,95,405,electric
418,buizel,55,65,35,60,30,85,330,water
419,floatzel,85,105,55,85,50,115,495,water
420,cherubi,45,35,45,62,53,35,275,grass
421,cherrim,70,60,70,87,78,85,450,grass
422,shellos,76,48,48,57,62,34,325,water
423,gastrodon,111,83,68,92,82,39,475,"ground, water"
424,ambipom,75,100,66,60,66,115,482,normal
425,drifloon,90,50,34,60,44,70,348,"ghost, flying"
426,drifblim,150,80,44,90,54,80,498,"ghost, flying"
427,buneary,55,66,44,44,56,85,350,normal
428,lopunny,65,76,84,54,96,105,480,normal
429,mismagius,60,60,60,105,105,105,495,ghost
430,honchkrow,100,125,52,105,52,71,505,"flying, dark"
431,glameow,49,55,42,42,37,85,310,normal
432,purugly,71,82,64,64,59,112,452,normal
433,chingling,45,30,50,65,50,45,285,psychic
434,stunky,63,63,47,41,41,74,329,"poison, dark"
435,skuntank,103,93,67,71,61,84,479,"poison, dark"
436,bronzor,57,24,86,24,86,23,300,"steel, psychic"
437,bronzong,67,89,116,79,116,33,500,"steel, psychic"
438,bonsly,50,80,95,10,45,10,290,rock
439,mime-jr,20,25,45,70,90,60,310,"psychic, fairy"
440,happiny,100,5,5,15,65,30,220,normal
441,chatot,76,65,45,92,42,91,411,"normal, flying"
442,spiritomb,50,92,108,92,108,35,485,"ghost, dark"
443,gible,58,70,45,40,45,42,300,"ground, dragon"
444,gabite,68,90,65,50,55,82,410,"ground, dragon"
445,garchomp,108,130,95,80,85,102,600,"ground, dragon"
446,munchlax,135,85,40,40,85,5,390,normal
447,riolu,40,70,40,35,40,60,285,fighting
448,lucario,70,110,70,115,70,90,525,"fighting, steel"
449,hippopotas,68,72,78,38,42,32,330,ground
450,hippowdon,108,112,118,68,72,47,525,ground
451,skorupi,40,50,90,30,55,65,330,"bug, poison"
452,drapion,70,90,110,60,75,95,500,"poison, dark"
453,croagunk,48,61,40,61,40,50,300,"fighting, poison"
454,toxicroak,83,106,65,86,65,85,490,"fighting, poison"
455,carnivine,74,100,72,90,72,46,454,grass
456,finneon,49,49,56,49,61,66,330,water
457,lumineon,69,69,76,69,86,91,460,water
458,mantyke,45,20,50,60,120,50,345,"flying, water"
459,snover,60,62,50,62,60,40,334,"ice, grass"
460,abomasnow,90,92,75,92,85,60,494,"ice, grass"
461,weavile,70,120,65,45,85,125,510,"ice, dark"
462,magnezone,70,70,115,130,90,60,535,"electric, steel"
463,lickilicky,110,85,95,80,95,50,515,normal
464,rhyperior,115,140,130,55,55,40,535,"ground, rock"
465,tangrowth,100,100,125,110,50,50,535,grass
466,electivire,75,123,67,95,85,95,540,electric
467,magmortar,75,95,67,125,95,83,540,fire
468,togekiss,85,50,95,120,115,80,545,"flying, fairy"
469,yanmega,86,76,86,116,56,95,515,"flying, bug"
470,leafeon,65,110,130,60,65,95,525,grass
471,glaceon,65,60,110,130,95,65,525,ice
472,gliscor,75,95,125,45,75,95,510,"flying, ground"
473,mamoswine,110,130,80,70,60,80,530,"ground, ice"
474,porygon-z,85,80,70,135,75,90,535,normal
475,gallade,68,125,65,65,115,80,518,"fighting, psychic"
476,probopass,60,55,145,75,150,40,525,"steel, rock"
477,dusknoir,45,100,135,65,135,45,525,ghost
478,froslass,70,80,70,80,70,110,480,"ghost, ice"
479,rotom,50,50,77,95,77,91,440,"ghost, electric"
480,uxie,75,75,130,75,130,95,580,psychic
481,mesprit,80,105,105,105,105,80,580,psychic
482,azelf,75,125,70,125,70,115,580,psychic
483,dialga,100,120,120,150,100,90,680,"steel, dragon"
484,palkia,90,120,100,150,120,100,680,"dragon, water"
485,heatran,91,90,106,130,106,77,600,"steel, fire"
486,regigigas,110,160,110,80,110,100,670,normal
487,giratina-altered,150,100,120,100,120,90,680,"ghost, dragon"
488,cresselia,120,70,110,75,120,85,580,psychic
489,phione,80,80,80,80,80,80,480,water
490,manaphy,100,100,100,100,100,100,600,water
491,darkrai,70,90,90,135,90,125,600,dark
492,shaymin-land,100,100,100,100,100,100,600,grass
493,arceus,120,120,120,120,120,120,720,normal
494,victini,100,100,100,100,100,100,600,"psychic, fire"
495,snivy,45,45,55,45,55,63,308,grass
496,servine,60,60,75,60,75,83,413,grass
497,serperior,75,75,95,75,95,113,528,grass
498,tepig,65,63,45,45,45,45,308,fire
499,pignite,90,93,55,70,55,55,418,"fighting, fire"
500,emboar,110,123,65,100,65,65,528,"fighting, fire"
501,oshawott,55,55,45,63,45,45,308,water
502,dewott,75,75,60,83,60,60,413,water
503,samurott,95,100,85,108,70,70,528,water
504,patrat,45,55,39,35,39,42,255,normal
505,watchog,60,85,69,60,69,77,420,normal
506,lillipup,45,60,45,25,45,55,275,normal
507,herdier,65,80,65,35,65,60,370,normal
508,stoutland,85,110,90,45,90,80,500,normal
509,purrloin,41,50,37,50,37,66,281,dark
510,liepard,64,88,50,88,50,106,446,dark
511,pansage,50,53,48,53,48,64,316,grass
512,simisage,75,98,63,98,63,101,498,grass
513,pansear,50,53,48,53,48,64,316,fire
514,simisear,75,98,63,98,63,101,498,fire
515,panpour,50,53,48,53,48,64,316,water
516,simipour,75,98,63,98,63,101,498,water
517,munna,76,25,45,67,55,24,292,psychic
518,musharna,116,55,85,107,95,29,487,psychic
519,pidove,50,55,50,36,30,43,264,"normal, flying"
520,tranquill,62,77,62,50,42,65,358,"normal, flying"
521,unfezant,80,115,80,65,55,93,488,"normal, flying"
522,blitzle,45,60,32,50,32,76,295,electric
523,zebstrika,75,100,63,80,63,116,497,electric
524,roggenrola,55,75,85,25,25,15,280,rock
525,boldore,70,105,105,50,40,20,390,rock
526,gigalith,85,135,130,60,80,25,515,rock
527,woobat,65,45,43,55,43,72,323,"flying, psychic"
528,swoobat,67,57,55,77,55,114,425,"flying, psychic"
529,drilbur,60,85,40,30,45,68,328,ground
530,excadrill,110,135,60,50,65,88,508,"ground, steel"
531,audino,103,60,86,60,86,50,445,normal
532,timburr,75,80,55,25,35,35,305,fighting
533,gurdurr,85,105,85,40,50,40,405,fighting
534,conkeldurr,105,140,95,55,65,45,505,fighting
535,tympole,50,50,40,50,40,64,294,water
536,palpitoad,75,65,55,65,55,69,384,"ground, water"
537,seismitoad,105,95,75,85,75,74,509,"ground, water"
538,throh,120,100,85,30,85,45,465,fighting
539,sawk,75,125,75,30,75,85,465,fighting
540,sewaddle,45,53,70,40,60,42,310,"grass, bug"
541,swadloon,55,63,90,50,80,42,380,"grass, bug"
542,leavanny,75,103,80,70,80,92,500,"grass, bug"
543,venipede,30,45,59,30,39,57,260,"bug, poison"
544,whirlipede,40,55,99,40,79,47,360,"bug, poison"
545,scolipede,60,100,89,55,69,112,485,"bug, poison"
546,cottonee,40,27,60,37,50,66,280,"grass, fairy"
547,whimsicott,60,67,85,77,75,116,480,"grass, fairy"
548,petilil,45,35,50,70,50,30,280,grass
549,lilligant,70,60,75,110,75,90,480,grass
550,basculin-red-striped,70,92,65,80,55,98,460,water
551,sandile,50,72,35,35,35,65,292,"ground, dark"
552,krokorok,60,82,45,45,45,74,351,"ground, dark"
553,krookodile,95,117,80,65,70,92,519,"ground, dark"
554,darumaka,70,90,45,15,45,50,315,fire
555,darmanitan-standard,105,140,55,30,55,95,480,fire
556,maractus,75,86,67,106,67,60,461,grass
557,dwebble,50,65,85,35,35,55,325,"bug, rock"
558,crustle,70,105,125,65,75,45,485,"bug, rock"
559,scraggy,50,75,70,35,70,48,348,"fighting, dark"
560,scrafty,65,90,115,45,115,58,488,"fighting, dark"
561,sigilyph,72,58,80,103,80,97,490,"flying, psychic"
562,yamask,38,30,85,55,65,30,303,ghost
563,cofagrigus,58,50,145,95,105,30,483,ghost
564,tirtouga,54,78,103,53,45,22,355,"rock, water"
565,carracosta,74,108,133,83,65,32,495,"rock, water"
566,archen,55,112,45,74,45,70,401,"flying, rock"
567,archeops,75,140,65,112,65,110,567,"flying, rock"
568,trubbish,50,50,62,40,62,65,329,poison
569,garbodor,80,95,82,60,82,75,474,poison
570,zorua,40,65,40,80,40,65,330,dark
571,zoroark,60,105,60,120,60,105,510,dark
572,minccino,55,50,40,40,40,75,300,normal
573,cinccino,75,95,60,65,60,115,470,normal
574,gothita,45,30,50,55,65,45,290,psychic
575,gothorita,60,45,70,75,85,55,390,psychic
576,gothitelle,70,55,95,95,110,65,490,psychic
577,solosis,45,30,40,105,50,20,290,psychic
578,duosion,65,40,50,125,60,30,370,psychic
579,reuniclus,110,65,75,125,85,30,490,psychic
580,ducklett,62,44,50,44,50,55,305,"flying, water"
581,swanna,75,87,63,87,63,98,473,"flying, water"
582,vanillite,36,50,50,65,60,44,305,ice
583,vanillish,51,65,65,80,75,59,395,ice
584,vanilluxe,71,95,85,110,95,79,535,ice
585,deerling,60,60,50,40,50,75,335,"normal, grass"
586,sawsbuck,80,100,70,60,70,95,475,"normal, grass"
587,emolga,55,75,60,75,60,103,428,"flying, electric"
588,karrablast,50,75,45,40,45,60,315,bug
589,escavalier,70,135,105,60,105,20,495,"steel, bug"
590,foongus,69,55,45,55,55,15,294,"grass, poison"
591,amoonguss,114,85,70,85,80,30,464,"grass, poison"
592,frillish,55,40,50,65,85,40,335,"ghost, water"
593,jellicent,100,60,70,85,105,60,480,"ghost, water"
594,alomomola,165,75,80,40,45,65,470,water
595,joltik,50,47,50,57,50,65,319,"electric, bug"
596,galvantula,70,77,60,97,60,108,472,"electric, bug"
597,ferroseed,44,50,91,24,86,10,305,"steel, grass"
598,ferrothorn,74,94,131,54,116,20,489,"steel, grass"
599,klink,40,55,70,45,60,30,300,steel
600,klang,60,80,95,70,85,50,440,steel
601,klinklang,60,100,115,70,85,90,520,steel
602,tynamo,35,55,40,45,40,60,275,electric
603,eelektrik,65,85,70,75,70,40,405,electric
604,eelektross,85,115,80,105,80,50,515,electric
605,elgyem,55,55,55,85,55,30,335,psychic
606,beheeyem,75,75,75,125,95,40,485,psychic
607,litwick,50,30,55,65,55,20,275,"ghost, fire"
608,lampent,60,40,60,95,60,55,370,"ghost, fire"
609,chandelure,60,55,90,145,90,80,520,"ghost, fire"
610,axew,46,87,60,30,40,57,320,dragon
611,fraxure,66,117,70,40,50,67,410,dragon
612,haxorus,76,147,90,60,70,97,540,dragon
613,cubchoo,55,70,40,60,40,40,305,ice
614,beartic,95,130,80,70,80,50,505,ice
615,cryogonal,80,50,50,95,135,105,515,ice
616,shelmet,50,40,85,40,65,25,305,bug
617,accelgor,80,70,40,100,60,145,495,bug
618,stunfisk,109,66,84,81,99,32,471,"ground, electric"
619,mienfoo,45,85,50,55,50,65,350,fighting
620,mienshao,65,125,60,95,60,105,510,fighting
621,druddigon,77,120,90,60,90,48,485,dragon
622,golett,59,74,50,35,50,35,303,"ground, ghost"
623,golurk,89,124,80,55,80,55,483,"ground, ghost"
624,pawniard,45,85,70,40,40,60,340,"steel, dark"
625,bisharp,65,125,100,60,70,70,490,"steel, dark"
626,bouffalant,95,110,95,40,95,55,490,normal
627,rufflet,70,83,50,37,50,60,350,"normal, flying"
628,braviary,100,123,75,57,75,80,510,"normal, flying"
629,vullaby,70,55,75,45,65,60,370,"flying, dark"
630,mandibuzz,110,65,105,55,95,80,510,"flying, dark"
631,heatmor,85,97,66,105,66,65,484,fire
632,durant,58,109,112,48,48,109,484,"steel, bug"
633,deino,52,65,50,45,50,38,300,"dragon, dark"
634,zweilous,72,85,70,65,70,58,420,"dragon, dark"
635,hydreigon,92,105,90,125,90,98,600,"dragon, dark"
636,larvesta,55,85,55,50,55,60,360,"fire, bug"
637,volcarona,85,60,65,135,105,100,550,"bug, fire"
638,cobalion,91,90,129,90,72,108,580,"steel, fighting"
639,terrakion,91,129,90,72,90,108,580,"fighting, rock"
640,virizion,91,90,72,90,129,108,580,"fighting, grass"
641,tornadus-incarnate,79,115,70,125,80,111,580,flying
642,thundurus-incarnate,79,115,70,125,80,111,580,"flying, electric"
643,reshiram,100,120,100,150,120,90,680,"dragon, fire"
644,zekrom,100,150,120,120,100,90,680,"electric, dragon"
645,landorus-incarnate,89,125,90,115,80,101,600,"ground, flying"
646,kyurem,125,130,90,130,90,95,660,"ice, dragon"
647,keldeo-ordinary,91,72,90,129,90,108,580,"fighting, water"
648,meloetta-aria,100,77,77,128,128,90,600,"normal, psychic"
649,genesect,71,120,95,120,95,99,600,"steel, bug"
650,chespin,56,61,65,48,45,38,313,grass
651,quilladin,61,78,95,56,58,57,405,grass
652,chesnaught,88,107,122,74,75,64,530,"fighting, grass"
653,fennekin,40,45,40,62,60,60,307,fire
654,braixen,59,59,58,90,70,73,409,fire
655,delphox,75,69,72,114,100,104,534,"psychic, fire"
656,froakie,41,56,40,62,44,71,314,water
657,frogadier,54,63,52,83,56,97,405,water
658,greninja,72,95,67,103,71,122,530,"dark, water"
659,bunnelby,38,36,38,32,36,57,237,normal
660,diggersby,85,56,77,50,77,78,423,"normal, ground"
661,fletchling,45,50,43,40,38,62,278,"normal, flying"
662,fletchinder,62,73,55,56,52,84,382,"flying, fire"
663,talonflame,78,81,71,74,69,126,499,"flying, fire"
664,scatterbug,38,35,40,27,25,35,200,bug
665,spewpa,45,22,60,27,30,29,213,bug
666,vivillon,80,52,50,90,50,89,411,"flying, bug"
667,litleo,62,50,58,73,54,72,369,"normal, fire"
668,pyroar,86,68,72,109,66,106,507,"normal, fire"
669,flabebe,44,38,39,61,79,42,303,fairy
670,floette,54,45,47,75,98,52,371,fairy
671,florges,78,65,68,112,154,75,552,fairy
672,skiddo,66,65,48,62,57,52,350,grass
673,gogoat,123,100,62,97,81,68,531,grass
674,pancham,67,82,62,46,48,43,348,fighting
675,pangoro,95,124,78,69,71,58,495,"fighting, dark"
676,furfrou,75,80,60,65,90,102,472,normal
677,espurr,62,48,54,63,60,68,355,psychic
678,meowstic-male,74,48,76,83,81,104,466,psychic
679,honedge,45,80,100,35,37,28,325,"ghost, steel"
680,doublade,59,110,150,45,49,35,448,"ghost, steel"
681,aegislash-shield,60,50,140,50,140,60,500,"ghost, steel"
682,spritzee,78,52,60,63,65,23,341,fairy
683,aromatisse,101,72,72,99,89,29,462,fairy
684,swirlix,62,48,66,59,57,49,341,fairy
685,slurpuff,82,80,86,85,75,72,480,fairy
686,inkay,53,54,53,37,46,45,288,"psychic, dark"
687,malamar,86,92,88,68,75,73,482,"psychic, dark"
688,binacle,42,52,67,39,56,50,306,"rock, water"
689,barbaracle,72,105,115,54,86,68,500,"rock, water"
690,skrelp,50,60,60,60,60,30,320,"poison, water"
691,dragalge,65,75,90,97,123,44,494,"dragon, poison"
692,clauncher,50,53,62,58,63,44,330,water
693,clawitzer,71,73,88,120,89,59,500,water
694,helioptile,44,38,33,61,43,70,289,"normal, electric"
695,heliolisk,62,55,52,109,94,109,481,"normal, electric"
696,tyrunt,58,89,77,45,45,48,362,"dragon, rock"
697,tyrantrum,82,121,119,69,59,71,521,"dragon, rock"
698,amaura,77,59,50,67,63,46,362,"ice, rock"
699,aurorus,123,77,72,99,92,58,521,"ice, rock"
700,sylveon,95,65,65,110,130,60,525,fairy
701,hawlucha,78,92,75,74,63,118,500,"flying, fighting"
702,dedenne,67,58,57,81,67,101,431,"electric, fairy"
703,carbink,50,50,150,50,150,50,500,"fairy, rock"
704,goomy,45,50,35,55,75,40,300,dragon
705,sliggoo,68,75,53,83,113,60,452,dragon
706,goodra,90,100,70,110,150,80,600,dragon
707,klefki,57,80,91,80,87,75,470,"steel, fairy"
708,phantump,43,70,48,50,60,38,309,"ghost, grass"
709,trevenant,85,110,76,65,82,56,474,"ghost, grass"
710,pumpkaboo-average,49,66,70,44,55,51,335,"ghost, grass"
711,gourgeist-average,65,90,122,58,75,84,494,"ghost, grass"
712,bergmite,55,69,85,32,35,28,304,ice
713,avalugg,95,117,184,44,46,28,514,ice
714,noibat,40,30,35,45,40,55,245,"flying, dragon"
715,noivern,85,70,80,97,80,123,535,"flying, dragon"
716,xerneas,126,131,95,131,98,99,680,fairy
717,yveltal,126,131,95,131,98,99,680,"flying, dark"
718,zygarde-50,108,100,121,81,95,95,600,"ground, dragon"
719,diancie,50,100,150,100,150,50,600,"fairy, rock"
720,hoopa,80,110,60,150,130,70,600,"ghost, psychic"
721,volcanion,80,110,120,130,90,70,600,"fire, water"
722,rowlet,68,55,55,50,50,42,320,"flying, grass"
723,dartrix,78,75,75,70,70,52,420,"flying, grass"
724,decidueye,78,107,75,100,100,70,530,"ghost, grass"
725,litten,45,65,40,60,40,70,320,fire
726,torracat,65,85,50,80,50,90,420,fire
727,incineroar,95,115,90,80,90,60,530,"fire, dark"
728,popplio,50,54,54,66,56,40,320,water
729,brionne,60,69,69,91,81,50,420,water
730,primarina,80,74,74,126,116,60,530,"fairy, water"
731,pikipek,35,75,30,30,30,65,265,"normal, flying"
732,trumbeak,55,85,50,40,50,75,355,"normal, flying"
733,toucannon,80,120,75,75,75,60,485,"normal, flying"
734,yungoos,48,70,30,30,30,45,253,normal
735,gumshoos,88,110,60,55,60,45,418,normal
736,grubbin,47,62,45,55,45,46,300,bug
737,charjabug,57,82,95,55,75,36,400,"electric, bug"
738,vikavolt,77,70,90,145,75,43,500,"electric, bug"
739,crabrawler,47,82,57,42,47,63,338,fighting
740,crabominable,97,132,77,62,67,43,478,"fighting, ice"
741,oricorio-baile,75,70,70,98,70,93,476,"flying, fire"
742,cutiefly,40,45,40,55,40,84,304,"bug, fairy"
743,ribombee,60,55,60,95,70,124,464,"bug, fairy"
744,rockruff,45,65,40,30,40,60,280,rock
745,lycanroc-midday,75,115,65,55,65,112,487,rock
746,wishiwashi-solo,45,20,20,25,25,40,175,water
747,mareanie,50,53,62,43,52,45,305,"poison, water"
748,toxapex,50,63,152,53,142,35,495,"poison, water"
749,mudbray,70,100,70,45,55,45,385,ground
750,mudsdale,100,125,100,55,85,35,500,ground
751,dewpider,38,40,52,40,72,27,269,"bug, water"
752,araquanid,68,70,92,50,132,42,454,"bug, water"
753,fomantis,40,55,35,50,35,35,250,grass
754,lurantis,70,105,90,80,90,45,480,grass
755,morelull,40,35,55,65,75,15,285,"grass, fairy"
756,shiinotic,60,45,80,90,100,30,405,"grass, fairy"
757,salandit,48,44,40,71,40,77,320,"fire, poison"
758,salazzle,68,64,60,111,60,117,480,"fire, poison"
759,stufful,70,75,50,45,50,50,340,"normal, fighting"
760,bewear,120,125,80,55,60,60,500,"normal, fighting"
761,bounsweet,42,30,38,30,38,32,210,grass
762,steenee,52,40,48,40,48,62,290,grass
763,tsareena,72,120,98,50,98,72,510,grass
764,comfey,51,52,90,82,110,100,485,fairy
765,oranguru,90,60,80,90,110,60,490,"normal, psychic"
766,passimian,100,120,90,40,60,80,490,fighting
767,wimpod,25,35,40,20,30,80,230,"bug, water"
768,golisopod,75,125,140,60,90,40,530,"bug, water"
769,sandygast,55,55,80,70,45,15,320,"ghost, ground"
770,palossand,85,75,110,100,75,35,480,"ground, ghost"
771,pyukumuku,55,60,130,30,130,5,410,water
772,type-null,95,95,95,95,95,59,534,normal
773,silvally,95,95,95,95,95,95,570,normal
774,minior-red-meteor,60,60,100,60,100,60,440,"flying, rock"
775,komala,65,115,65,75,95,65,480,normal
776,turtonator,60,78,135,91,85,36,485,"dragon, fire"
777,togedemaru,65,98,63,40,73,96,435,"steel, electric"
778,mimikyu-disguised,55,90,80,50,105,96,476,"ghost, fairy"
779,bruxish,68,105,70,70,70,92,475,"psychic, water"
780,drampa,78,60,85,135,91,36,485,"normal, dragon"
781,dhelmise,70,131,100,86,90,40,517,"ghost, grass"
782,jangmo-o,45,55,65,45,45,45,300,dragon
783,hakamo-o,55,75,90,65,70,65,420,"fighting, dragon"
784,kommo-o,75,110,125,100,105,85,600,"fighting, dragon"
785,tapu-koko,70,115,85,95,75,130,570,"electric, fairy"
786,tapu-lele,70,85,75,130,115,95,570,"psychic, fairy"
787,tapu-bulu,70,130,115,85,95,75,570,"grass, fairy"
788,tapu-fini,70,75,115,95,130,85,570,"fairy, water"
789,cosmog,43,29,31,29,31,37,200,psychic
790,cosmoem,43,29,131,29,131,37,400,psychic
791,solgaleo,137,137,107,113,89,97,680,"steel, psychic"
792,lunala,137,113,89,137,107,97,680,"ghost, psychic"
793,nihilego,109,53,47,127,131,103,570,"poison, rock"
794,buzzwole,107,139,139,53,53,79,570,"fighting, bug"
795,pheromosa,71,137,37,137,37,151,570,"fighting, bug"
796,xurkitree,83,89,71,173,71,83,570,electric
797,celesteela,97,101,103,107,101,61,570,"flying, steel"
798,kartana,59,181,131,59,31,109,570,"steel, grass"
799,guzzlord,223,101,53,97,53,43,570,"dragon, dark"
800,necrozma,97,107,101,127,89,79,600,psychic
801,magearna,80,95,115,130,115,65,600,"steel, fairy"
802,marshadow,90,125,80,90,90,125,600,"ghost, fighting"
803,poipole,67,73,67,73,67,73,420,poison
804,naganadel,73,73,73,127,73,121,540,"dragon, poison"
805,stakataka,61,131,211,53,101,13,570,"steel, rock"
806,blacephalon,53,127,53,151,79,107,570,"ghost, fire"
807,zeraora,88,112,75,102,80,143,600,electric
808,meltan,46,65,65,55,35,34,300,steel
809,melmetal,135,143,143,80,65,34,600,steel
810,grookey,50,65,50,40,40,65,310,grass
811,thwackey,70,85,70,55,60,80,420,grass
812,rillaboom,100,125,90,60,70,85,530,grass
813,scorbunny,50,71,40,40,40,69,310,fire
814,raboot,65,86,60,55,60,94,420,fire
815,cinderace,80,116,75,65,75,119,530,fire
816,sobble,50,40,40,70,40,70,310,water
817,drizzile,65,60,55,95,55,90,420,water
818,inteleon,70,85,65,125,65,120,530,water
819,skwovet,70,55,55,35,35,25,275,normal
820,greedent,120,95,95,55,75,20,460,normal
821,rookidee,38,47,35,33,35,57,245,flying
822,corvisquire,68,67,55,43,55,77,365,flying
823,corviknight,98,87,105,53,85,67,495,"flying, steel"
824,blipbug,25,20,20,25,45,45,180,bug
825,dottler,50,35,80,50,90,30,335,"psychic, bug"
826,orbeetle,60,45,110,80,120,90,505,"psychic, bug"
827,nickit,40,28,28,47,52,50,245,dark
828,thievul,70,58,58,87,92,90,455,dark
829,gossifleur,40,40,60,40,60,10,250,grass
830,eldegoss,60,50,90,80,120,60,460,grass
831,wooloo,42,40,55,40,45,48,270,normal
832,dubwool,72,80,100,60,90,88,490,normal
833,chewtle,50,64,50,38,38,44,284,water
834,drednaw,90,115,90,48,68,74,485,"rock, water"
835,yamper,59,45,50,40,50,26,270,electric
836,boltund,69,90,60,90,60,121,490,electric
837,rolycoly,30,40,50,40,50,30,240,rock
838,carkol,80,60,90,60,70,50,410,"fire, rock"
839,coalossal,110,80,120,80,90,30,510,"fire, rock"
840,applin,40,40,80,40,40,20,260,"grass, dragon"
841,flapple,70,110,80,95,60,70,485,"grass, dragon"
842,appletun,110,85,80,100,80,30,485,"grass, dragon"
843,silicobra,52,57,75,35,50,46,315,ground
844,sandaconda,72,107,125,65,70,71,510,ground
845,cramorant,70,85,55,85,95,85,475,"flying, water"
846,arrokuda,41,63,40,40,30,66,280,water
847,barraskewda,61,123,60,60,50,136,490,water
848,toxel,40,38,35,54,35,40,242,"electric, poison"
849,toxtricity-amped,75,98,70,114,70,75,502,"electric, poison"
850,sizzlipede,50,65,45,50,50,45,305,"bug, fire"
851,centiskorch,100,115,65,90,90,65,525,"fire, bug"
852,clobbopus,50,68,60,50,50,32,310,fighting
853,grapploct,80,118,90,70,80,42,480,fighting
854,sinistea,40,45,45,74,54,50,308,ghost
855,polteageist,60,65,65,134,114,70,508,ghost
856,hatenna,42,30,45,56,53,39,265,psychic
857,hattrem,57,40,65,86,73,49,370,psychic
858,hatterene,57,90,95,136,103,29,510,"psychic, fairy"
859,impidimp,45,45,30,55,40,50,265,"fairy, dark"
860,morgrem,65,60,45,75,55,70,370,"fairy, dark"
861,grimmsnarl,95,120,65,95,75,60,510,"fairy, dark"
862,obstagoon,93,90,101,60,81,95,520,"normal, dark"
863,perrserker,70,110,100,50,60,50,440,steel
864,cursola,60,95,50,145,130,30,510,ghost
865,sirfetchd,62,135,95,68,82,65,507,fighting
866,mr-rime,80,85,75,110,100,70,520,"psychic, ice"
867,runerigus,58,95,145,50,105,30,483,"ground, ghost"
868,milcery,45,40,40,50,61,34,270,fairy
869,alcremie,65,60,75,110,121,64,495,fairy
870,falinks,65,100,100,70,60,75,470,fighting
871,pincurchin,48,101,95,91,85,15,435,electric
872,snom,30,25,35,45,30,20,185,"ice, bug"
873,frosmoth,70,65,60,125,90,65,475,"ice, bug"
874,stonjourner,100,125,135,20,20,70,470,rock
875,eiscue-ice,75,80,110,65,90,50,470,ice
876,indeedee-male,60,65,55,105,95,95,475,"normal, psychic"
877,morpeko-full-belly,58,95,58,70,58,97,436,"electric, dark"
878,cufant,72,80,49,40,49,40,330,steel
879,copperajah,122,130,69,80,69,30,500,steel
880,dracozolt,90,100,90,80,70,75,505,"electric, dragon"
881,arctozolt,90,100,90,90,80,55,505,"electric, ice"
882,dracovish,90,90,100,70,80,75,505,"dragon, water"
883,arctovish,90,90,100,80,90,55,505,"ice, water"
884,duraludon,70,95,115,120,50,85,535,"steel, dragon"
885,dreepy,28,60,30,40,30,82,270,"ghost, dragon"
886,drakloak,68,80,50,60,50,102,410,"ghost, dragon"
887,dragapult,88,120,75,100,75,142,600,"ghost, dragon"
888,zacian,92,120,115,80,115,138,660,fairy
889,zamazenta,92,120,115,80,115,138,660,fighting
890,eternatus,140,85,95,145,95,130,690,"dragon, poison"
891,kubfu,60,90,60,53,50,72,385,fighting
892,urshifu-single-strike,100,130,100,63,60,97,550,"fighting, dark"
893,zarude,105,120,105,70,95,105,600,"grass, dark"
894,regieleki,80,100,50,100,50,200,580,electric
895,regidrago,200,100,50,100,50,80,580,dragon
896,glastrier,100,145,130,65,110,30,580,ice
897,spectrier,100,65,60,145,80,130,580,ghost
898,calyrex,100,80,80,80,80,80,500,"psychic, grass"
899,wyrdeer,103,105,72,105,75,65,525,"normal, psychic"
900,kleavor,70,135,95,45,70,85,500,"bug, rock"
901,ursaluna,130,140,105,45,80,50,550,"normal, ground"
902,basculegion-male,120,112,65,80,75,78,530,"ghost, water"
903,sneasler,80,130,60,40,80,120,510,"fighting, poison"
904,overqwil,85,115,95,65,65,85,510,"poison, dark"
905,enamorus-incarnate,74,115,70,135,80,106,580,"flying, fairy"
906,sprigatito,40,61,54,45,45,65,310,grass
907,floragato,61,80,63,60,63,83,410,grass
908,meowscarada,76,110,70,81,70,123,530,"grass, dark"
909,fuecoco,67,45,59,63,40,36,310,fire
910,crocalor,81,55,78,90,58,49,411,fire
911,skeledirge,104,75,100,110,75,66,530,"ghost, fire"
912,quaxly,55,65,45,50,45,50,310,water
913,quaxwell,70,85,65,65,60,65,410,water
914,quaquaval,85,120,80,85,75,85,530,"fighting, water"
915,lechonk,54,45,40,35,45,35,254,normal
916,oinkologne-male,110,100,75,59,80,65,489,normal
917,tarountula,35,41,45,29,40,20,210,bug
918,spidops,60,79,92,52,86,35,404,bug
919,nymble,33,46,40,21,25,45,210,bug
920,lokix,71,102,78,52,55,92,450,"bug, dark"
921,pawmi,45,50,20,40,25,60,240,electric
922,pawmo,60,75,40,50,40,85,350,"electric, fighting"
923,pawmot,70,115,70,70,60,105,490,"electric, fighting"
924,tandemaus,50,50,45,40,45,75,305,normal
925,maushold-family-of-four,74,75,70,65,75,111,470,normal
926,fidough,37,55,70,30,55,65,312,fairy
927,dachsbun,57,80,115,50,80,95,477,fairy
928,smoliv,41,35,45,58,51,30,260,"normal, grass"
929,dolliv,52,53,60,78,78,33,354,"normal, grass"
930,arboliva,78,69,90,125,109,39,510,"normal, grass"
931,squawkabilly-green-plumage,82,96,51,45,51,92,417,"normal, flying"
932,nacli,55,55,75,35,35,25,280,rock
933,naclstack,60,60,100,35,65,35,355,rock
934,garganacl,100,100,130,45,90,35,500,rock
935,charcadet,40,50,40,50,40,35,255,fire
936,armarouge,85,60,100,125,80,75,525,"psychic, fire"
937,ceruledge,75,125,80,60,100,85,525,"ghost, fire"
938,tadbulb,61,31,41,59,35,45,272,electric
939,bellibolt,109,64,91,103,83,45,495,electric
940,wattrel,40,40,35,55,40,70,280,"flying, electric"
941,kilowattrel,70,70,60,105,60,125,490,"flying, electric"
942,maschiff,60,78,60,40,51,51,340,dark
943,mabosstiff,80,120,90,60,70,85,505,dark
944,shroodle,40,65,35,40,35,75,290,"normal, poison"
945,grafaiai,63,95,65,80,72,110,485,"normal, poison"
946,bramblin,40,65,30,45,35,60,275,"ghost, grass"
947,brambleghast,55,115,70,80,70,90,480,"ghost, grass"
948,toedscool,40,40,35,50,100,70,335,"ground, grass"
949,toedscruel,80,70,65,80,120,100,515,"ground, grass"
950,klawf,70,100,115,35,55,75,450,rock
951,capsakid,50,62,40,62,40,50,304,grass
952,scovillain,65,108,65,108,65,75,486,"grass, fire"
953,rellor,41,50,60,31,58,30,270,bug
954,rabsca,75,50,85,115,100,45,470,"psychic, bug"
955,flittle,30,35,30,55,30,75,255,psychic
956,espathra,95,60,60,101,60,105,481,psychic
957,tinkatink,50,45,45,35,64,58,297,"steel, fairy"
958,tinkatuff,65,55,55,45,82,78,380,"steel, fairy"
959,tinkaton,85,75,77,70,105,94,506,"steel, fairy"
960,wiglett,10,55,25,35,25,95,245,water
961,wugtrio,35,100,50,50,70,120,425,water
962,bombirdier,70,103,85,60,85,82,485,"flying, dark"
963,finizen,70,45,40,45,40,75,315,water
964,palafin-zero,100,70,72,53,62,100,457,water
965,varoom,45,70,63,30,45,47,300,"steel, poison"
966,revavroom,80,119,90,54,67,90,500,"steel, poison"
967,cyclizar,70,95,65,85,65,121,501,"normal, dragon"
968,orthworm,70,85,145,60,55,65,480,steel
969,glimmet,48,35,42,105,60,60,350,"poison, rock"
970,glimmora,83,55,90,130,81,86,525,"poison, rock"
971,greavard,50,61,60,30,55,34,290,ghost
972,houndstone,72,101,100,50,97,68,488,ghost
973,flamigo,82,115,74,75,64,90,500,"flying, fighting"
974,cetoddle,108,68,45,30,40,43,334,ice
975,cetitan,170,113,65,45,55,73,521,ice
976,veluza,90,102,73,78,65,70,478,"psychic, water"
977,dondozo,150,100,115,65,65,35,530,water
978,tatsugiri-curly,68,50,60,120,95,82,475,"dragon, water"
979,annihilape,110,115,80,50,90,90,535,"ghost, fighting"
980,clodsire,130,75,60,45,100,20,430,"ground, poison"
981,farigiraf,120,90,70,110,70,60,520,"normal, psychic"
982,dudunsparce-two-segment,125,100,80,85,75,55,520,normal
983,kingambit,100,135,120,60,85,50,550,"steel, dark"
984,great-tusk,115,131,131,53,53,87,570,"ground, fighting"
985,scream-tail,115,65,99,65,115,111,570,"psychic, fairy"
986,brute-bonnet,111,127,99,79,99,55,570,"grass, dark"
987,flutter-mane,55,55,55,135,135,135,570,"ghost, fairy"
988,slither-wing,85,135,79,85,105,81,570,"fighting, bug"
989,sandy-shocks,85,81,97,121,85,101,570,"ground, electric"
990,iron-treads,90,112,120,72,70,106,570,"ground, steel"
991,iron-bundle,56,80,114,124,60,136,570,"ice, water"
992,iron-hands,154,140,108,50,68,50,570,"electric, fighting"
993,iron-jugulis,94,80,86,122,80,108,570,"flying, dark"
994,iron-moth,80,70,60,140,110,110,570,"fire, poison"
995,iron-thorns,100,134,110,70,84,72,570,"electric, rock"
996,frigibax,65,75,45,35,45,55,320,"ice, dragon"
997,arctibax,90,95,66,45,65,62,423,"ice, dragon"
998,baxcalibur,115,145,92,75,86,87,600,"ice, dragon"
999,gimmighoul,45,30,70,75,70,10,300,ghost
1000,gholdengo,87,60,95,133,91,84,550,"ghost, steel"
1001,wo-chien,85,85,100,95,135,70,570,"grass, dark"
1002,chien-pao,80,120,80,90,65,135,570,"ice, dark"
1003,ting-lu,155,110,125,55,80,45,570,"ground, dark"
1004,chi-yu,55,80,80,135,120,100,570,"fire, dark"
1005,roaring-moon,105,139,71,55,101,119,590,"dragon, dark"
1006,iron-valiant,74,130,90,120,60,116,590,"fighting, fairy"
1007,koraidon,100,135,115,85,100,135,670,"fighting, dragon"
1008,miraidon,100,85,100,135,115,135,670,"electric, dragon"
1009,walking-wake,99,83,91,125,83,109,590,"dragon, water"
1010,iron-leaves,90,130,88,70,108,104,590,"psychic, grass"
1011,dipplin,80,80,110,95,80,40,485,"grass, dragon"
1012,poltchageist,40,45,45,74,54,50,308,"ghost, grass"
1013,sinistcha,71,60,106,121,80,70,508,"ghost, grass"
1014,okidogi,88,128,115,58,86,80,555,"fighting, poison"
1015,munkidori,88,75,66,130,90,106,555,"psychic, poison"
1016,fezandipiti,88,91,82,70,125,99,555,"fairy, poison"
1017,ogerpon,80,120,84,60,96,110,550,grass
1018,archaludon,90,105,130,125,65,85,600,"steel, dragon"
1019,hydrapple,106,80,110,120,80,44,540,"grass, dragon"
1020,gouging-fire,105,115,121,65,93,91,590,"dragon, fire"
1021,raging-bolt,125,73,91,137,89,75,590,"electric, dragon"
1022,iron-boulder,90,120,80,68,108,124,590,"psychic, rock"
1023,iron-crown,90,72,100,122,108,98,590,"steel, psychic"
1024,terapagos,90,65,85,65,85,60,450,normal
1025,pecharunt,88,88,160,88,88,88,600,"ghost, poison"
